1872 1871 1870 1869 1868 1867 1866 1865 1864 1863 1862 1861 1860 1417 1859 1858 1416 1857 1856 1415 1855 2165 2164 1854 1414 1853 2163 1852 1413 1412 1851 2162 1411 2161 2160 1850 1410 2159 1849 2158 2157 1848 1409 2156 1847 1408 2155 1407 1765 2154 1406 1706 1846 1405 2001 2153 1155 2002 1404 1845 2152 1403 1844 2003 2004 1402 2005 1843 1154 2151 2006 1842 1401 2007 2150 1707 1841 1153 2008 2149 1400 1840 2009 2148 1152 1708 2147 2010 1839 1151 2146 1709 2011 1150 1838 1710 1149 2145 2012 1837 1148 1711 1399 2013 1147 1836 1146 1712 2144 2014 1398 1835 1145 1834 2015 1144 1397 2143 1833 1143 1196 1197 2142 1195 1198 1199 1194 1193 1200 1201 1202 1192 2016 1203 1191 1142 1204 1205 1206 1209 1190 1207 1208 1189 1713 1210 1141 1188 1832 1187 1140 1714 2141 1186 1831 1139 1185 1211 1184 1212 1138 1183 1213 1214 1715 1137 1182 2017 1181 1215 1830 1180 1165 1716 1136 1179 1166 1216 2140 1717 1829 1178 1167 1177 1217 1168 1176 1309 1828 1135 1169 1226 1227 1228 1175 1225 2139 1170 1171 1172 1173 1174 1218 1229 1718 1224 1230 1219 1231 1232 1396 1134 1220 1223 1308 2138 2018 1221 1222 1233 1719 1133 1827 1720 2137 1234 1235 1132 1236 1254 1721 1253 1255 1252 1256 1251 2136 1131 1237 1250 1722 1238 1240 1241 1249 1239 1242 1257 1395 1248 1130 1243 1247 1244 1245 1246 1826 2019 2135 1723 1129 1258 1128 1307 2134 1394 2095 2096 2094 1127 2097 2093 1724 2098 2092 2099 2133 1126 2091 1725 2020 2100 2090 1306 1726 2089 1125 2101 2102 2108 1393 1727 2088 1825 2107 1124 2103 2087 2106 1305 2104 2105 1728 2021 2132 1729 1824 1123 2086 1304 2022 1823 2085 2131 1730 2084 1731 1822 2023 1303 1732 2083 1122 2082 1733 2125 2126 2081 2124 2080 2130 2024 2123 2127 2122 2128 2129 2079 1821 1121 2121 2078 2025 1820 1734 2186 1120 1392 1819 2120 1735 2077 1736 1818 1119 2119 1737 1817 1118 2076 1738 1816 2118 2185 1117 1815 2075 2117 1739 1302 2184 2116 1814 1116 1391 1813 2115 1740 1812 1115 2026 1741 2074 2114 1811 1390 1301 1742 
432 431 433 430 434 429 428 427 426 425 435 436 424 423 437 438 422 421 439 420 440 419 418 441 417 442 416 443 415 414 444 445 413 412 411 446 410 447 409 408 448 407 449 406 450 1447 66 1446 405 451 67 65 452 1445 68 404 453 64 69 1444 63 403 62 402 454 70 455 401 1443 61 400 71 399 1442 72 60 398 73 59 397 1441 396 58 395 74 394 57 1440 393 75 392 56 456 391 76 55 457 54 77 78 390 458 53 1439 389 459 52 1438 79 388 460 387 461 51 1437 386 462 50 1436 80 1435 385 49 81 1434 384 463 383 82 48 1433 83 1432 382 754 381 380 379 47 1431 378 753 84 752 377 751 46 1430 376 750 375 85 749 374 45 1429 748 1428 373 44 747 1427 43 372 746 86 371 87 1426 745 370 744 1425 88 42 369 743 1424 89 41 368 742 367 90 40 39 741 1423 91 366 92 38 1422 740 365 93 37 739 364 738 1259 1418 1260 1419 94 1261 737 1420 1262 36 1263 1264 1268 1267 1266 1265 363 1272 1271 1270 1269 1273 1546 1545 1544 1274 362 736 95 1543 1275 361 35 1472 2281 2282 1473 360 2294 2297 735 1421 96 2283 1276 359 2295 2296 2284 1668 1474 2285 34 2286 1475 358 734 1277 1476 97 2287 1278 357 2288 733 2289 1667 1279 2290 33 356 1280 1477 2291 1281 2292 98 355 1282 732 354 2293 1283 1284 353 352 351 32 1285 1478 731 345 350 346 344 347 343 349 99 1286 348 342 1479 730 464 341 465 340 1448 1287 31 1480 729 1288 466 339 1289 728 1481 1290 1291 1482 1292 727 1666 467 1293 30 1483 726 1294 338 468 100 1295 29 725 1296 1484 101 1297 337 28 724 469 1298 1485 102 1299 1486 1300 470 1665 336 27 471 1487 335 1556 723 1557 1555 1554 1558 1488 26 1559 1560 1553 103 1489 1552 1551 722 1547 1664 1550 1548 1490 1561 104 25 1549 1631 1491 472 1663 1562 1632 24 721 105 1492 106 107 23 1493 334 108 720 22 1494 1662 1563 109 1495 21 333 719 110 1661 1496 20 1564 111 473 1497 19 332 1660 1498 718 112 18 1565 113 474 331 17 1539 1540 1538 1499 1541 1537 1542 1536 717 1500 1535 1501 1534 114 1502 1533 1503 1532 475 1504 1630 330 716 1566 1505 1629 1506 1628 1627 715 1507 115 1567 1531 1508 1626 1530 1509 714 1568 476 1510 1569 329 1625 713 1624 1659 1570 1571 712 1572 1623 1573 328 1622 1621 711 1574 16 710 1620 327 15 1575 709 116 1619 
2183 1743 2113 1114 1809 1389 1744 2112 1745 1808 2073 1388 1746 2111 2072 1113 1807 1747 2071 1112 2182 1748 1387 2110 1806 1111 2181 1749 2180 2070 1110 1750 2179 2027 1805 1751 2178 1109 2069 2028 134 135 1752 2068 1804 136 137 1108 2067 1386 2177 2029 138 2176 1107 139 1803 2066 140 523 524 525 2167 2168 2169 526 2065 2166 2170 187 188 2064 2109 189 527 141 186 2063 185 1802 184 1106 190 707 2171 191 183 192 142 193 194 528 706 195 1753 1105 529 2175 143 196 1385 144 705 182 1754 1801 145 704 181 197 703 198 146 702 530 147 1755 199 180 2174 1384 701 531 200 179 1104 1383 148 1756 201 178 532 700 1800 1382 699 698 2030 533 177 202 1757 1381 534 149 2031 697 176 1380 203 150 151 1799 2032 2173 204 696 175 1379 535 152 2033 536 153 695 1378 2034 1758 205 1103 537 174 154 1798 694 1377 2035 155 538 2036 693 1759 1376 156 173 172 2172 2037 206 157 692 1375 171 1760 1102 2038 170 207 1797 691 1374 208 169 2039 1373 1761 209 1101 690 1796 2040 689 210 168 1372 1100 1762 688 1371 158 2041 1795 211 167 1099 1763 687 1794 1370 212 159 686 2042 160 213 685 1098 1764 161 2043 684 1369 214 1793 166 162 1097 165 1792 164 163 215 2044 1791 2224 1368 683 1096 1790 682 2045 216 2223 681 2222 2062 1095 2046 1789 1367 2221 2061 217 2047 1094 1366 1093 1788 2220 1365 2060 1092 680 2048 679 2219 218 1364 1091 678 1363 677 1787 1090 2218 1362 219 676 756 757 758 755 759 675 1361 674 1089 667 666 673 668 2217 672 669 665 671 670 664 1360 1088 663 2216 662 2215 661 2059 1087 2049 660 2214 1359 220 659 1086 2213 658 1358 657 1357 221 1786 2058 2212 2050 656 2211 1085 2210 2057 2051 655 2209 2052 1356 654 1084 2053 2208 1785 2207 2054 1355 2206 653 2055 2205 652 2204 2056 222 651 1354 650 649 2203 648 1083 647 646 645 1353 223 1940 1784 644 1352 2202 1082 2201 1351 1941 2200 643 642 1350 641 640 2199 1349 639 2198 224 638 1348 637 1347 636 2197 1346 1783 1345 635 1942 2196 225 634 1081 1782 2195 862 1344 226 2194 1343 1781 861 2193 1342 1943 1080 1780 860 1341 1779 2192 1340 859 227 1079 1778 2191 2190 1339 1078 858 1944 1338 2189 228 2188 857 229 1337 1077 856 1777 1945 2187 230 1336 855 1946 1076 1947 1335 854 1948 1334 1776 1075 1949 853 1333 231 1775 852 1950 1074 1774 1332 232 851 850 1773 1331 849 848 233 1330 
14 477 1576 117 1618 326 1577 1658 1617 1511 478 13 1578 1616 1657 12 479 1579 325 1580 480 1585 1584 1583 1615 1582 118 1586 1581 1614 1587 1656 1597 324 323 1669 481 1613 11 322 1612 482 1588 1608 1611 1589 1609 1610 483 1512 1607 484 321 1590 1606 119 485 1591 486 320 487 1594 1593 1592 319 1595 1605 488 318 1596 317 1513 2280 1604 1601 1602 1603 489 316 1600 315 1599 314 490 313 10 491 1598 492 1670 1655 120 1514 9 493 312 121 494 122 311 1671 1654 8 1515 495 310 123 2279 1516 7 309 1072 496 124 1694 1672 6 1071 1517 1653 1070 125 5 126 1673 1518 1652 1069 1695 1068 1067 1696 1519 2278 1674 1651 4 1066 1675 1650 127 1065 2277 1064 1697 1698 3 1699 1700 1063 128 1701 1520 2 1676 1649 1702 1703 129 1704 1 1062 1705 308 1463 1464 1462 1061 497 1461 130 1465 1060 1057 1158 1157 1159 1059 1058 307 0 1648 1156 1160 498 1677 131 1161 1164 133 1162 1163 1914 1466 132 539 1915 1913 1678 1647 1467 1916 540 2772 2771 2276 1912 633 1468 1460 1917 1469 1471 1470 1911 632 2773 2770 1918 1910 541 1459 1909 1919 631 306 1646 1458 1908 2275 1920 1457 2769 2774 1907 1921 1456 1455 2274 630 1454 1453 1452 2768 1645 542 2775 1451 1922 1906 543 629 1521 544 305 499 628 1450 627 1449 545 1923 1905 626 1522 546 1924 625 1904 1523 1925 1903 547 2767 548 624 1524 549 2766 1926 550 623 2776 551 1902 622 552 621 620 1901 619 1927 1900 553 304 2298 1899 500 1525 618 1928 1644 303 501 1679 1643 2299 1929 1898 554 555 1680 1642 617 1897 616 2765 1930 2777 302 615 556 502 1681 1931 1896 614 1526 1682 1641 1527 1529 1683 1640 1684 1639 557 1528 1685 1932 1895 1686 1688 1687 613 2764 2778 558 2763 559 1638 560 1689 612 1933 1894 561 611 562 301 1637 610 503 609 1934 1893 563 300 504 1690 1636 2390 608 2443 1935 1892 564 1635 1691 1766 607 1767 299 565 505 1768 606 566 1769 1891 298 506 1770 605 1771 1890 567 1772 568 507 604 297 603 569 2300 1634 570 602 296 571 601 572 1889 508 600 599 2762 573 574 1888 598 597 1692 575 2301 576 596 2761 295 577 595 578 509 594 593 579 1887 580 592 1633 591 1693 2454 581 2760 582 2302 590 589 294 583 1886 510 584 588 2455 585 293 587 292 586 511 291 1976 1885 1975 2759 1974 2444 2389 1884 1973 290 512 2456 2303 1972 289 1971 513 2445 2388 1970 2446 1969 2487 2461 1968 1967 2304 2800 2486 2758 1966 2589 288 2593 2594 2592 2590 2591 514 2595 1965 1883 2462 2596 2485 1964 2757 2484 287 2597 2457 2600 2598 515 2601 2599 1882 2602 1963 2756 2305 2387 286 2603 2447 516 1962 2463 2604 2605 2755 2483 1881 2606 1961 285 2464 2442 284 2607 517 283 1879 1880 1878 518 282 2608 1936 1877 519 281 2482 2609 520 2465 2754 1937 1876 280 2441 2610 521 279 1938 1875 522 278 277 2391 2466 1939 1874 2481 1873 2611 2440 2467 2386 2480 2448 2392 2439 2306 2479 2753 2438 2612 2393 2458 2613 
1951 234 847 1329 846 1952 1328 845 1953 844 1327 235 843 1326 842 1954 841 1955 236 1325 840 839 1956 1324 838 237 837 1957 836 835 834 833 832 831 1323 830 829 1958 1322 828 827 1321 238 826 1320 1959 825 1319 1318 1317 1316 824 1315 823 1960 239 1314 822 821 820 819 1313 240 818 2000 1999 817 1998 1997 1312 816 241 1996 1311 815 814 1995 813 1310 812 811 1977 1994 810 1993 242 1978 1992 1979 1980 1991 809 1981 1990 1982 808 1985 1984 1983 1986 1989 1988 1987 807 806 805 804 803 243 802 801 800 799 798 797 244 796 795 794 793 245 792 791 790 789 788 787 786 785 863 784 783 864 782 865 2922 781 866 779 780 778 246 777 776 2921 775 247 248 249 774 2920 773 250 772 771 2919 251 770 2914 2913 2918 2912 2915 2917 2916 2911 769 252 253 254 768 2910 255 2904 767 2903 2902 2909 2901 275 274 256 257 271 270 269 272 258 2900 268 989 988 2908 273 267 266 265 990 987 264 986 263 259 985 766 991 984 997 262 260 983 2907 261 2899 2905 2906 992 982 993 996 995 994 981 2416 765 980 979 978 2394 977 2898 764 976 763 2897 2415 975 2414 2417 974 2896 762 973 2437 2895 972 761 971 2395 2894 2396 2413 2436 970 2418 760 2435 969 2472 2473 2397 968 2412 2434 2893 2419 2263 2471 967 2474 966 2262 2411 2420 2261 2892 2260 965 2259 2421 2398 2470 2475 2258 2433 964 2257 963 2256 962 2399 2459 2460 2891 2400 2432 2890 961 960 2889 998 2401 2255 959 2431 999 958 2476 2410 2422 2469 2477 957 2888 2402 2468 2478 2403 2254 2430 2887 2874 2875 2876 2873 1000 2877 2872 2429 956 2886 2878 2404 2253 2885 2409 2879 2428 2884 2880 2881 2883 2405 2882 2871 2252 2423 2408 2406 2424 2407 2427 2425 2341 2340 2342 2343 2339 2344 2338 2345 2337 2346 2251 2336 2347 2426 2348 2349 2250 2870 1001 955 1002 954 2249 2248 1003 2247 2246 953 1004 952 1005 1006 1007 2588 1008 2335 2587 1009 1010 1011 2245 2350 951 1012 2633 950 1013 2634 949 1014 948 942 947 941 946 943 940 945 944 939 1015 938 937 2651 2351 2586 1016 2244 936 935 2585 2334 2352 2243 1017 2652 1018 2584 934 2653 2242 1019 2333 2353 933 2583 2332 2354 1020 2241 932 2582 931 2654 1021 930 2581 2655 1022 2331 2355 929 928 2449 2656 2240 2385 2450 2451 2384 2452 2383 2239 2330 2329 2453 2356 927 2328 2382 2357 
2307 2614 2752 2615 2616 2617 2751 2618 2750 2799 2308 2619 2380 2620 2798 2749 2309 2310 2379 2632 2748 2378 2631 2797 2311 2747 2377 2621 2630 2312 2746 2629 2376 2622 2313 2745 2628 2375 2314 2627 2626 2625 2623 2315 2624 2374 2744 2316 2317 2373 2318 2372 2371 2319 2370 2743 2369 2320 2321 2368 2742 2367 2322 2366 2741 2323 2365 2364 2796 2740 2739 2324 2327 2326 2738 2325 2363 2381 2362 2361 2360 2737 2358 2359 2736 2735 2734 2733 2732 2731 2795 2730 2729 2728 2727 2726 2794 2725 2793 2792 2724 2791 2790 2789 2723 2788 2787 2722 2786 2721 2720 2719 2718 2785 2717 2716 2784 2783 2715 2714 2713 2782 2712 2711 2710 2709 2781 2708 2707 2706 2705 2704 2703 2780 2702 2701 2700 2779 2699 2698 2697 2696 2695 2694 2693 2692 2691 2690 2689 2867 2688 2866 2865 2687 2864 2686 2863 2685 2862 2684 2683 2682 2681 2680 2679 2678 2677 2676 2668 2667 2669 2666 2670 2671 2675 2672 2664 2665 2673 2674 2663 2662 2661 2660 2659 2658 2861 2657 2860 2579 2578 2577 2859 2576 2858 2575 2857 2574 2856 2573 2855 2854 2853 2572 2852 2851 2850 2571 2849 2570 2848 2847 2846 2569 2845 2568 2844 2567 926 2566 2843 925 924 2565 923 2564 2842 2841 922 2840 2563 921 2562 2561 920 2839 919 2560 2559 2838 2837 2558 2836 918 917 916 2835 2557 2556 2834 2555 915 2833 2554 914 2832 913 2831 912 2553 911 2552 910 2551 2225 2226 2227 909 1023 2228 2830 2229 2230 2550 908 1024 2231 2549 2829 2232 907 2233 2548 1025 2273 2547 2546 2545 2234 2544 2828 906 1026 2272 2235 2543 2827 2541 2236 2542 2540 2539 2826 2237 2635 2538 2636 2825 2238 2637 2537 2536 2638 2824 2535 2639 2271 2640 2534 2823 2641 2533 2642 2822 2643 2532 2644 2531 2530 905 1027 2270 2821 2529 2820 1028 1029 904 2819 2269 2818 1030 903 2528 902 2268 2817 2527 2816 1031 901 2526 2815 2267 2525 2266 2814 2513 2512 2511 2524 2510 900 2514 2509 1032 2515 2516 2265 2523 2508 2517 2518 2507 2522 2519 2520 2521 2264 2506 2813 2505 2504 899 1033 2812 2503 898 1034 2811 1035 2502 897 2501 2500 2810 896 1036 2809 2808 2499 895 1037 2498 2807 2497 894 1038 2496 893 1039 2806 2495 892 1040 2805 2494 891 1041 2493 2804 2803 890 2802 1042 2801 2492 2868 2491 2490 2869 2489 2488 2645 2646 2650 2647 2649 889 2648 1043 888 1044 887 1045 886 1046 885 1047 884 1048 883 1049 1050 882 881 1051 880 1052 879 1053 878 1054 877 1055 1056 876 875 874 873 872 
870 869 868 867 
